CCCCWWCCCC
CCCCWWCCCC
CCCCWWCCCC
CCCCWWCCCC
CCCCCCCCCC
CCCCCCCCCC
CCCCWWCCCC
CCCCWWCCCC
CCCCWWCCTC
CCCCWWCCCC